444444444444444444444444444444
400000000000000000000000000004
400010000600000000000000100004
400000000000001000000000000004
400000010000000000000020000004
420000000000000000000000000004
400000003000001000000000000004
400010000000000000000000100004
400000000000000000003000000004
400002000000600000000000000004
400000000000000000000000000004
400100000000002000000001000004
400000000000000000000000000004
400000001000000000003000000004
400000000000000000000000000004
400000020000000000000100000004
400100000000000000200000000004
400000000300000000000000003004
400000000000000000000000000004
400020000000000000000000100004
400000010000000010000000000004
400000000000000000000000000004
450000000000000000000000000004
420000003000000010000000000004