010000001000000010000000000001
000000000000000000000000000000
000010000000000000000000100000
000000000000001000000000000000
000000010000000000000020000000
020000000000000000000000000000
000000003000001000000000000000
000010000000000000000000100000
000000000000000000003000000000
000002000000000000000000000000
000000000000000000000000000000
000100000000002000000001000000
000000000000000000000000000000
000000001000000000003000000000
000000000000000000000000000000
000000020000000000000100000000
000100000000000000200000000000
000000000300000000000000003000
000000000000000000000000000000
000020000000000000000000100000
000000010000000010000000000000
000000000000000000000000000000
000000000000000000000000000000
444444444444444444444444444444